

EA ./path_to_the_east_texture
SO ./path_to_the_south_texture
WE ./path_to_the_west_texture
NO ./path_to_the_north_texture
C 225 ,30,1      
F 220,100,5
        11      111111   1 1 1 1111
        1111111111111111111111111111
        10000000001100111000000011
        11001100000111001000000001
        10010000000000111000000011
111111111011000001110000000000001
100000000011000001110111111111111
11110111111111011100000010001
11110111111111011101010010001
1100000011011011100000010001          
100000000N0000001100000010001
10000000000000001101010000001
11000001110101011111011110111
11110111 1110101 101111010001
11111111 1111111 111111111111






