EA           ./assets/greystone.xpm               
SO ./assets/purplestone.xpm
WE ./assets/redbrick.xpm
NO ./assets/wood.xpm            


C 28,187,255             
F 70, 70, 70




        11      111111   1 1 1 1111
        1111111111111111111111111111
        10000000001100111000000011              111
        11001100000111001000000001              10111
        10010000000000111000000011              1N001
111111111011000001110000000000001               11111





